`=Why not just use "?
test=DUH I'M HERE
aero=lemon
lemon=aero
ping=ping pong, ... you ding dong.
hoe=Never waste your diamonds on a hoe.
aww=Eww no.
fun=Time for fun fun Mr. Funyun :D
roses=Roses are red, Violets are blue, I have a gun, Get in the van.
hi=hello
slug=IntOREnet will be a thing I swear
nuup=nuup: it's only gay after you're 5cm inside someone, nuup: so I can never be gay
harambe=Dicks out for harambe!, R.I.P. you sweet prince!
laythe=Most of my existence can be summed up as a compilation of yo mama jokes.
israel=ISRAEL IS BEST COUNTRY
kek=kek <- this one, kek, kek
rekt=https://www.youtube.com/watch?v=sS_cAAAhgPM
foo=bar
servers=Build: mc.openredstone.org - 84.215.69.184:25569, School: sc.openredstone.org - 97.89.20.163:25565, Survival: ss.openredstone.org - 162.243.90.113:25573
snek=A long carnivorous legless reptile otherwise known as a snake. 
tuchi=Salty Mc Saltster
beans=Imma do the things that I wanna do, I ain't got a thing to prove to you, I'll eat my candy with the pork and beans, Excuse my manners if I make a scene, I ain't gonna wear the clothes that you like, I'm fine and dandy with the me inside, one look in the mirror and I'm tickled pink, I don't give a hoot about what you think, https://www.youtube.com/watch?v=PQHPYelqr0E
cca=carry cancer ladder
spam=spam spam spam spam spam spam spam spam spam spam spam spam spam spam spam spam spam spam spam spam spam spam spam spam spam spam spam spam spam spam spam spam spam spam spam spam spam spam spam spam spam spam spam spam spam spam spam spam spam spam spam spam spam spam spam spam spam spam spam spam spam spam spam spam spam spam spam spam spam spam spam spam spam spam spam spam spam spam spam spam spam spam spam spam spam spam spam spam spam spam spam spam
lag=Oh IDK probably caused by Maze.
maze="1 giant sphere of lava coming right up..."
join=Yes we need fun commands back.
leave=What did I just say?
nickster=Ugh why did you call me?
rtfs="Read the Fucking Slack!" What originally began as a Staff joke RTFS devolved into anything that one has not been actively interested in or "out-of-touch"., "God you still don't know what is going on? RTFS" - "You are so out-of-touch!"
nicenick=That sexy beast of a guy!, What a Nick!
